R 1280 720
SO ./texture/redbrick.xpm
NO ./texture/Hittler.xpm
WE ./texture/hell_pent01.xpm
EA ./texture/WALL34.xpm
S ./texture/wood.xpm
F 0,191,255
C 244,164,96

               111111111111111111
        11111111001100001
        101100000111000001
        100100000000000001
1111111110110000011100000011
100000000000000001110111111111111
11110111111110000000000010001
11110111111110011100010010001
110000001101000111000000000011111111111
10000000000000000000000000001
1000200000000000110000000000011
100000000000000011010100100001
11000001110101011111011110N0111
11110111 1110101 101111 10001
11111111 1111111 11111111111