R 1231231232 1312312312

SO ./texture/redbrick.xpm                           
NO ./texture/stone.xpm
WE ./texture/mossy.xpm
EA ./texture/wood.xpm
S  ./texture/barrel.xpm
F 0,  0,   0
C 0255,244,233
111111111
10000001
120000111
1111001
100E001
1111111