R  1920 1080
SO ./texture/redbrick.xpm
NO ./texture/stone.xpm
WE ./texture/WALL34.xpm

EA ./texture/wood.xpm
S ./texture/barrel.xpm

F 0,191,255
C 244,164,0
  
1111111111
1000000001
1000000001
1000000001
1000000001
1000000001
1000000001
1000000001
1000000001
1000000021
1000000001
10E0000001
1000000001
1000000001
1000000001
1000000001
1000000001
1111111111
