R  1920 1080
SO ./texture/redbrick.xpm
NO ./texture/12.xpm
WE ./texture/Hittler.xpm
EA ./texture/WALL34.xpm
S ./texture/barrel.xpm
F 0,191,255
C 244,164,0
  
1111111
1000001
1002001
120W001
1200001
1000001
1000011
1000001
1000001
1000001
1000001
1000001
1000001
1000001
1000001
1000001
1000001
1000001
1000001
1111111