
R 1000 600
SO ./texture/wood.xpm                       
NO ./texture/redbrick.xpm
WE ./texture/stone.xpm
EA ./texture/mossy.xpm
S  ./texture/barrel.xpm
F 100,  100,   100
C 0255,244,255


 1111111111
1000E000021
11111111111