R 3213123 12312312

SO ./texture/redbrick.xpm                           
NO ./texture/stone.xpm
WE ./texture/mossy.xpm
EA ./texture/wood.xpm
S  ./texture/barrel.xpm
F 0,  0,   0             
C 0255,244,233
111111111
12200001
122000111
1111001
100E001
1111111