            R 1111111103192381920380128301823981028310 132131231829319023810293102938123

SO ./texture/redbrick.xpm                               

NO ./texture/stone.xpm

WE ./texture/mossy.xpm
EA ./texture/wood.xpm
S  ./texture/barrel.xpm  
F 0,0,0
C 255,255,255

1111
1001
1201
1001
1N01
1111